64,64,10,10
-1,1,1,1,1,1,1,1,-1,-1
-1,1,2,2,0,2,2,1,-1,-1
-1,1,2,2,2,2,2,1,-1,-1
-1,1,2,3,2,3,2,1,-1,-1
-1,1,2,2,2,2,2,1,-1,-1
-1,1,2,2,3,2,2,1,-1,-1
-1,1,2,2,2,2,2,1,-1,-1
-1,1,2,2,2,2,2,1,-1,-1
-1,1,2,2,4,2,2,1,-1,-1
-1,1,1,1,1,1,1,1,-1,-1
