64,64,40,40
1,1,1,1,1,1,1,1,1,1,1,1,1,1,1,1,1,1,1,1,1,1,1,1,-1,-1,-1,-1,1,1,1,1,1,1,1,-1,-1,-1,-1,-1
1,2,4,2,1,2,2,2,2,2,2,1,2,2,2,2,1,2,2,2,2,2,2,1,-1,-1,-1,-1,1,2,2,2,2,2,1,1,1,1,1,1
1,2,2,2,1,2,2,2,2,2,2,1,3,2,7,2,1,2,2,2,2,2,2,1,-1,-1,-1,-1,1,2,8,8,8,2,2,2,2,2,2,1
1,2,2,2,1,3,2,2,1,2,2,1,2,2,2,2,1,2,2,1,5,2,2,1,-1,-1,-1,-1,1,2,8,8,8,2,2,2,2,0,2,1
1,3,2,2,1,2,2,2,1,2,2,1,2,2,2,2,1,2,2,1,2,2,2,1,-1,-1,-1,-1,1,2,8,8,8,2,2,2,2,2,2,1
1,2,2,2,1,2,3,2,1,2,2,1,2,2,3,2,1,2,2,1,2,2,2,1,-1,-1,-1,-1,1,2,3,2,3,2,1,1,1,1,1,1
1,2,2,3,1,2,2,2,1,2,2,1,2,3,2,2,1,2,2,1,5,2,2,1,-1,-1,-1,-1,1,2,2,2,2,2,1,-1,-1,-1,-1,-1
1,2,2,2,1,2,2,3,1,2,2,2,2,2,2,2,2,2,2,1,2,2,2,1,-1,-1,-1,-1,1,2,5,2,2,2,1,-1,-1,-1,-1,-1
1,3,2,2,1,3,2,2,1,2,2,2,2,2,2,2,2,2,2,1,2,2,2,1,-1,-1,-1,-1,1,2,2,2,2,2,1,-1,-1,-1,-1,-1
1,2,2,2,1,2,2,2,1,1,1,1,1,1,1,1,1,1,1,1,5,2,2,1,-1,-1,-1,-1,1,2,3,2,3,2,1,-1,-1,-1,-1,-1
1,2,2,2,1,2,2,2,2,2,2,2,2,2,2,2,2,2,2,2,2,2,2,1,-1,-1,-1,-1,1,2,2,2,2,2,1,-1,-1,-1,-1,-1
1,2,2,3,1,2,2,2,2,2,2,2,2,2,2,2,2,2,2,2,2,2,2,1,-1,-1,-1,-1,1,1,1,2,1,1,1,-1,-1,-1,-1,-1
1,2,2,2,1,8,8,8,8,8,8,1,2,2,2,2,1,1,1,1,1,1,1,1,-1,-1,-1,-1,-1,-1,-1,6,-1,-1,-1,-1,-1,-1,-1,-1
1,2,3,2,1,8,8,8,8,8,8,1,3,2,3,2,1,-1,-1,-1,-1,-1,-1,-1,-1,-1,-1,-1,-1,-1,-1,2,-1,-1,-1,-1,-1,-1,-1,-1
1,2,2,2,1,8,8,8,8,8,8,1,2,2,2,2,1,-1,-1,1,1,1,1,1,1,1,1,1,1,1,1,2,1,1,1,-1,-1,-1,-1,-1
1,2,2,2,1,8,8,8,8,8,8,8,2,2,2,3,1,-1,-1,1,2,2,2,2,2,3,2,2,2,2,2,2,2,2,1,-1,-1,-1,-1,-1
1,2,2,2,1,8,8,8,8,8,8,8,2,3,2,2,1,-1,-1,1,2,2,2,2,2,2,2,2,2,3,2,2,2,2,1,-1,-1,-1,-1,-1
1,2,2,2,1,8,8,8,8,8,8,8,2,2,2,2,1,-1,-1,1,2,3,2,2,2,2,2,2,2,2,2,2,2,2,1,-1,-1,-1,-1,-1
1,2,2,2,2,8,8,8,8,8,8,8,2,2,2,3,1,-1,-1,1,2,2,2,1,1,1,1,1,1,1,1,1,1,1,1,-1,-1,-1,-1,-1
1,2,2,2,2,2,2,2,2,2,2,2,2,2,2,2,1,-1,-1,1,2,2,2,1,-1,-1,-1,-1,-1,-1,-1,-1,-1,-1,-1,-1,-1,-1,-1,-1
1,2,2,2,2,2,2,2,2,2,2,2,2,2,2,2,1,-1,-1,1,2,2,2,1,1,1,1,1,1,1,1,1,1,1,1,1,1,1,-1,-1
1,2,2,2,2,8,8,8,8,8,8,8,2,2,2,2,1,-1,-1,1,2,3,2,2,2,2,2,2,2,2,2,2,2,2,2,2,2,1,-1,-1
1,1,1,1,1,8,8,8,8,8,8,8,1,1,1,1,1,-1,-1,1,2,2,2,2,2,2,2,2,2,2,2,2,2,3,2,2,2,1,-1,-1
-1,-1,-1,-1,-1,8,8,8,8,8,8,8,-1,-1,-1,-1,-1,-1,-1,1,2,2,2,2,2,2,2,3,2,2,2,2,2,2,2,2,3,1,-1,-1
-1,-1,-1,-1,-1,8,8,8,8,8,8,8,-1,-1,-1,-1,-1,-1,-1,1,1,1,1,1,1,1,1,1,1,1,1,1,2,2,2,2,2,1,-1,-1
-1,-1,-1,-1,-1,-1,-1,-1,-1,-1,-1,-1,-1,-1,-1,-1,-1,-1,-1,-1,-1,-1,-1,-1,-1,-1,-1,-1,-1,-1,-1,1,5,2,2,2,3,1,-1,-1
-1,-1,-1,-1,-1,-1,-1,-1,-1,-1,-1,-1,-1,-1,-1,-1,-1,-1,-1,-1,-1,-1,-1,-1,-1,-1,-1,-1,-1,-1,-1,1,2,2,2,2,2,1,-1,-1
1,1,1,1,1,1,1,1,1,-1,-1,1,1,1,1,1,1,1,1,1,-1,-1,-1,-1,-1,-1,-1,-1,-1,-1,-1,1,2,2,5,2,2,1,-1,-1
1,2,2,2,2,2,2,2,1,-1,-1,1,2,2,2,2,2,2,2,1,-1,-1,-1,-1,-1,-1,-1,-1,-1,-1,-1,1,2,2,2,2,2,1,-1,-1
1,2,7,2,2,2,2,2,2,6,6,2,2,2,2,2,2,2,2,1,-1,-1,-1,-1,-1,-1,-1,-1,-1,-1,-1,1,5,2,2,2,3,1,-1,-1
1,2,2,2,2,2,2,2,1,-1,-1,1,2,2,2,2,2,2,2,1,-1,-1,-1,-1,-1,-1,-1,-1,-1,-1,-1,1,2,2,2,2,2,1,-1,-1
1,1,1,1,1,1,1,1,1,-1,-1,1,1,1,1,1,2,2,2,1,-1,-1,-1,-1,-1,-1,-1,-1,-1,-1,-1,1,2,2,5,2,2,1,-1,-1
-1,-1,-1,-1,-1,-1,-1,-1,-1,-1,-1,-1,-1,-1,-1,1,2,2,2,1,-1,-1,-1,-1,-1,-1,-1,-1,-1,-1,-1,1,2,2,2,2,2,1,-1,-1
1,1,1,1,1,1,1,1,1,1,1,1,1,1,1,1,2,2,2,1,-1,-1,1,1,1,1,1,1,1,-1,-1,1,5,2,2,2,3,1,-1,-1
1,2,2,2,2,2,2,2,2,2,2,2,2,2,2,2,2,2,2,1,-1,-1,1,2,2,2,2,2,1,-1,-1,1,2,2,2,2,2,1,-1,-1
1,2,2,1,1,1,1,1,1,1,1,1,1,1,1,1,1,1,1,1,-1,-1,1,2,2,2,2,2,1,-1,-1,1,2,2,3,2,2,1,-1,-1
1,2,2,1,-1,-1,-1,-1,-1,-1,-1,-1,-1,-1,-1,-1,-1,-1,-1,-1,-1,-1,1,2,2,2,2,2,2,6,6,2,2,2,2,2,2,1,-1,-1
1,2,2,1,1,1,1,1,1,1,1,1,1,1,1,1,1,1,1,1,1,1,1,2,2,2,2,2,1,-1,-1,1,2,2,2,2,2,1,-1,-1
1,2,2,2,2,2,2,2,2,2,2,2,2,2,2,2,2,2,2,2,2,2,2,2,2,2,2,2,1,-1,-1,1,2,2,2,2,2,1,-1,-1
1,1,1,1,1,1,1,1,1,1,1,1,1,1,1,1,1,1,1,1,1,1,1,1,1,1,1,1,1,-1,-1,1,1,1,1,1,1,1,-1,-1
